             ##
            ####
           ######
          ########
         ##########   
        ############
       ##############
      ################
     ##################
    ####################
   ######################
  ########################
