 ######  ####  ######   ##     ##    ###    
##    ##  ##  ##    ##  ###   ###   ## ##   
##        ##  ##        #### ####  ##   ##  
 ######   ##  ##   #### ## ### ## ##     ## 
      ##  ##  ##    ##  ##     ## ######### 
##    ##  ##  ##    ##  ##     ## ##     ## 
 ######  ####  ######   ##     ## ##     ## 