                  ##
                 ####
                ######
               ########
              ##########   
             ############
  ###################################
     #############################
        ######################
         ####################
        ##########  ##########
       ##########    ##########
      ##########      ##########